1111111
10C00P1
1000001
10000E1
1111111