1111111111111
10000000000C1
10P0000000001
1000000000001
1000111110001
1100000000001
1C0000C0001E1
1111111111111