111111111111111111
100000000000000001
10P0P0000000000001
1000000C0000000001
100000000000010001
100E00000000001001
100000000000010001
111111111111111111