111111111111111111
100000000000000001
100P00000000000001
10000000C000000001
100000000000010001
1000000000001E1001
100000000000010001
111111111111111111