111111111111111111
100100000000000001
101P10000000000001
100100000000000001
1000000000000C0001
1000000000000E0001
100000000000000001
111111111111111111