111111111111111111
100C00E0000P000001
111111111111111111