111111111111111111
100000000000000001
100000000000000001
100000000000000001
100000000000010001
100000000000101001
100000000000010001
111111111111111111