111111111111111111
10000000000C000001
100P00000000000C01
1000000C0000000001
1000C0000000010001
100000000000101001
1000000C0000010E01
111111111111111111